%%%%%%%
%     %
% %%% %
% %.G %
% %%% %
%P    %
%%%%%%%
